lilnififififffff		mnhfjomsjsgfkogq
lilnififififfgff		mnhfjomsjsgflkis
lilnififififfhff		mnhfjomsjsgfliks
lilnififififfiff		mnhfjomsjsgflphn
lilnififififfjff		mnhfjomsjsgfkgft
lilnififififfkff		mnhfjomsjsgflhgt
lilnififififflff		mnhfjomsjsgfjoig
lilnififififfmff		mnhfjomsjsgfkqmp
lilnififififfnff		mnhfjomsjsgfhsho
lilnififififfoff		mnhfjomsjsgfgmjq
lilnififififfpff		mnhfjomsjsgfhgli
lilnififififfqff		mnhfjomsjsgfkskl
lilnififififfrff		mnhfjomsjsgfhtml
lilnififififfsff		mnhfjomsjsgfjpgr
lilnififififftff		mnhfjomsjsgfmkkk
lilnififififfuff		mnhfjomsjsgfmsmo
lilnififififgfff		mnhfjomsjsgfmgii
lilnififififggff		mnhfjomsjsgfikku
lilnififififghff		mnhfjomsjsgfgumn
lilnififififgiff		mnhfjomsjsgfishm
lilnififififgjff		mnhfjomsjsgflsgk
lilnififififgkff		mnhfjomsjsgffuln
lilnififififglff		mnhfjomsjsgfirin
lilnififififgmff		mnhfjomsjsgfgthf
lilnififififgnff		mnhfjomsjsgfinll
lilnififififgoff		mnhfjomsjsgfgghk
lilnififififgpff		mnhfjomsjsgfhkls
lilnififififgqff		mnhfjomsjsgfkplh
lilnififififgrff		mnhfjomsjsgfgqlk
lilnififififgsff		mnhfjomsjsgfiuff
lilnififififgtff		mnhfjomsjsgfhmmg
lilnififififguff		mnhfjomsjsgfmimh
lilnififififhfff		mnhfjomsjsgfiikh
lilnififififhgff		mnhfjomsjsgfmoml
lilnififififhhff		mnhfjomsjsgfkjff
lilnififififhiff		mnhfjomsjsgfgkgg
lilnififififhjff		mnhfjomsjsgfilmo
lilnififififhkff		mnhfjomsjsgfhofk
lilnififififhlff		mnhfjomsjsgfgrmn
lilnififififhmff		mnhfjomsjsgfifko
lilnififififhnff		mnhfjomsjsgflfji
lilnififififhoff		mnhfjomsjsgfijlf
lilnififififhpff		mnhfjomsjsgfkhlf
lilnififififhqff		mnhfjomsjsgfgjfk
lilnififififhrff		mnhfjomsjsgfjqjk
lilnififififhsff		mnhfjomsjsgfhpmo
lilnififififhtff		mnhfjomsjsgffrkp
lilnififififhuff		mnhfjomsjsgfjsgl
lilnifififififff		mnhfjomsjsgfimlo
lilnififififigff		mnhfjomsjsgfhiml
lilnififififihff		mnhfjomsjsgfflhs
lilnififififiiff		mnhfjomsjsgfjhjl
lilnififififijff		mnhfjomsjsgffhkp
lilnififififikff		mnhfjomsjsgfmuin
lilnififififilff		mnhfjomsjsgfgikk
lilnififififimff		mnhfjomsjsgfgfjk
lilnififififinff		mnhfjomsjsgfjuml
lilnififififioff		mnhfjomsjsgfiplr
lilnififififipff		mnhfjomsjsgflljk
lilnififififiqff		mnhfjomsjsgfglln
lilnififififirff		mnhfjomsjsgfmjii
lilnififififisff		mnhfjomsjsgfloig
lilnififififitff		mnhfjomsjsgfhlfu
lilnififififiuff		mnhfjomsjsgfitgq
lilnififififjfff		mnhfjomsjsgffmgs
lilnififififjgff		mnhfjomsjsgfiggu
lilnififififjhff		mnhfjomsjsgfjfir
lilnififififjiff		mnhfjomsjsgfljkh
lilnififififjjff		mnhfjomsjsgfmqjq
lilnififififjkff		mnhfjomsjsgfjjfr
lilnififififjlff		mnhfjomsjsgfghim
lilnififififjmff		mnhfjomsjsgffngh
lilnififififjnff		mnhfjomsjsgflrgn
lilnififififjoff		mnhfjomsjsgfmfku
lilnififififjpff		mnhfjomsjsgfluir
lilnififififjqff		mnhfjomsjsgffiji
lilnififififjrff		mnhfjomsjsgfjthg
lilnififififjsff		mnhfjomsjsgfkrln
lilnififififjtff		mnhfjomsjsgffokt
lilnififififjuff		mnhfjomsjsgfmnks
lilnififififkfff		mnhfjomsjsgflngf
lilnififififkgff		mnhfjomsjsgfltft
lilnififififkhff		mnhfjomsjsgfmhkr
lilnififififkiff		mnhfjomsjsgfffji
lilnififififkjff		mnhfjomsjsgffjks
lilnififififkkff		mnhfjomsjsgfhrhu
lilnififififklff		mnhfjomsjsgfktgr
lilnififififkmff		mnhfjomsjsgflqli
lilnififififknff		mnhfjomsjsgffsgi
lilnififififkoff		mnhfjomsjsgfhumh
lilnififififkpff		mnhfjomsjsgfkfjt
lilnififififkqff		mnhfjomsjsgffkkg
lilnififififkrff		mnhfjomsjsgfkijf
lilnififififksff		mnhfjomsjsgfioik
lilnififififktff		mnhfjomsjsgfjigk
lilnififififkuff		mnhfjomsjsgfhnkk
lilnififififlfff		mnhfjomsjsgfgpgh
lilnififififlgff		mnhfjomsjsgfgoip
lilnififififlhff		mnhfjomsjsgfkugk
lilnififififliff		mnhfjomsjsgfhfmp
lilnififififljff		mnhfjomsjsgfgsmp
lilnififififlkff		mnhfjomsjsgfmpmr
lilnififififllff		mnhfjomsjsgfftim
lilnififififlmff		mnhfjomsjsgfmrih
lilnififififlnff		mnhfjomsjsgflmkg
lilnififififloff		mnhfjomsjsgfknhq
lilnififififlpff		mnhfjomsjsgfmlkm
lilnififififlqff		mnhfjomsjsgfmmli
lilnififififlrff		mnhfjomsjsgffqiq
lilnififififlsff		mnhfjomsjsgffphr
lilnififififltff		mnhfjomsjsgfkmhj
lilnififififluff		mnhfjomsjsgfhjhf
lilnififififmfff		mnhfjomsjsgfhqmm
lilnififififmgff		mnhfjomsjsgfkljn
lilnififififmhff		mnhfjomsjsgflggs
lilnififififmiff		mnhfjomsjsgfjmkp
lilnififififmjff		mnhfjomsjsgfjllq
lilnififififmkff		mnhfjomsjsgfjgks
lilnififififmlff		mnhfjomsjsgfjkgh
lilnififififmmff		mnhfjomsjsgfgngp
lilnififififmnff		mnhfjomsjsgfiqkl
lilnififififmoff		mnhfjomsjsgfhhmq
lilnififififmpff		mnhfjomsjsgffgis
lilnififififmqff		mnhfjomsjsgfjrij
lilnififififmrff		mnhfjomsjsgfkklo
lilnififififmsff		mnhfjomsjsgfihht
lilnififififmtff		mnhfjomsjsgfmthg
lilnififififmuff		mnhfjomsjsgfjnip
