liffffffffffffff		mnmpifjihijghpkp
lifgffffffffffff		mnilgshtkikjghfp
lifhffffffffffff		mnkliiijhslifqhu
lififfffffffffff		mnkqikmgimmkkfkr
lifjffffffffffff		mnhqjhhthlltjlgq
lifkffffffffffff		mnjhjighfqmkjskm
liflffffffffffff		mnfijththuhllnmi
lifmffffffffffff		mnkgjplgmtgshoko
lifnffffffffffff		mnkpktfgfiksgiim
lifoffffffffffff		mnjofnfklfitjfjt
lifpffffffffffff		mnhuiifmjuiqkjhg
lifqffffffffffff		mnmgllimkojghmhn
lifrffffffffffff		mnhtgpmhjfgnjsfg
lifsffffffffffff		mnhnhhhkkrlujjhu
liftffffffffffff		mnkhhsfqggkfgkio
lifuffffffffffff		mnkomjjmgologqmk
ligfffffffffffff		mnksjpfjfjltlsfu
liggffffffffffff		mnkjgqisjigflogh
lighffffffffffff		mnfmjofjgklkgsgu
ligiffffffffffff		mnlifnjshpjokjjt
ligjffffffffffff		mnfjmqljmmiiiikr
ligkffffffffffff		mnfkkkfojifumpfq
liglffffffffffff		mnjlmifnlgmsmpig
ligmffffffffffff		mnknlpiuhifffhju
lignffffffffffff		mnjfigkmishhmifl
ligoffffffffffff		mniniiifkhigijkt
ligpffffffffffff		mniqmjhmirhkhjlh
ligqffffffffffff		mnjuffjlgrmthpfl
ligrffffffffffff		mnirhjkslsgsjsjn
ligsffffffffffff		mnmiklighmikkpfs
ligtffffffffffff		mnlqhhjqfoiojpjs
liguffffffffffff		mnlohujqlrihjkks
lihfffffffffffff		mngrhnmpjofflgkg
lihgffffffffffff		mnhrmufsjpmifjgn
lihhffffffffffff		mnihjkhrgsfmhlmq
lihiffffffffffff		mnggligqkmloltlm
lihjffffffffffff		mnjkgkgfhpmfkmfo
lihkffffffffffff		mnlnmqflmnjmmqlo
lihlffffffffffff		mnmmktfklnkolmgp
lihmffffffffffff		mnlkjkmoftljgshf
lihnffffffffffff		mnmhgilogtjtmfig
lihoffffffffffff		mnimkjfnkihjmumn
lihpffffffffffff		mnkugojsgljkjhlr
lihqffffffffffff		mngohjmlltmukslt
lihrffffffffffff		mngfgoknkimnfkih
lihsffffffffffff		mnhpgrjigljolfms
lihtffffffffffff		mnfgltghfkmqghif
lihuffffffffffff		mnfojpfglhjgkuhm
liifffffffffffff		mnghifitikfoimkg
liigffffffffffff		mnfukifrgjlsknis
liihffffffffffff		mnfpjomomphphign
liiiffffffffffff		mngmflfslhkojqlh
liijffffffffffff		mnlpmsgghnmggolt
liikffffffffffff		mnhhkqkglogumght
liilffffffffffff		mnjqgplnhkkfkugm
liimffffffffffff		mnmjhjknfmkjffki
liinffffffffffff		mngifimuhmiokjmk
liioffffffffffff		mnjmmlkrfhgufigp
liipffffffffffff		mnhglnllknjujiii
liiqffffffffffff		mnitfljiksmojsjs
liirffffffffffff		mnkmjsghjsjgitgm
liisffffffffffff		mnllglmnimgujfjt
liitffffffffffff		mnjrjkmmjujpghln
liiuffffffffffff		mnkkijiolfifhshq
lijfffffffffffff		mnlfihmrhugljnhr
lijgffffffffffff		mnmogrlifplqmihh
lijhffffffffffff		mnlrgqlsknhokihl
lijiffffffffffff		mnkthfgpjthlllip
lijjffffffffffff		mnmlksmmjphofijt
lijkffffffffffff		mnlgjjlrkpmufkkj
lijlffffffffffff		mnjnimmlhfmmkjff
lijmffffffffffff		mnjpklkghhloghgo
lijnffffffffffff		mngulnlpkflslhfq
lijoffffffffffff		mnmnhlfqhlmkilms
lijpffffffffffff		mnftlkmgimlplrkl
lijqffffffffffff		mnjijgjrmphkhnmg
lijrffffffffffff		mnifhlgrikkqfnhr
lijsffffffffffff		mnjtihkskhmsjpjf
lijtffffffffffff		mnlukgkigsfilthq
lijuffffffffffff		mngqjmgufpmkfshi
likfffffffffffff		mnlhmrlnimljfqgi
likgffffffffffff		mnioiqhufsjrfskh
likhffffffffffff		mnijmnjtjtglktgh
likiffffffffffff		mnkiikjufmipiuin
likjffffffffffff		mngniigrgpfphjmm
likkffffffffffff		mnfqfphmlmmfjtjr
liklffffffffffff		mniujtmukgfkgqgp
likmffffffffffff		mnjjmjguljmtmnlj
liknffffffffffff		mnglkolqhrfjhtgh
likoffffffffffff		mnkfghlshflpkhkl
likpffffffffffff		mnhmlrfuikinkoji
likqffffffffffff		mnhifihrgrlnhmlp
likrffffffffffff		mnlsmllnliihhtgk
liksffffffffffff		mngtgphjfgjjjtfk
liktffffffffffff		mnmtgpgpfrmngrgp
likuffffffffffff		mnfrggfnfjjsghjh
lilfffffffffffff		mnmuiogmitjphsjm
lilgffffffffffff		mngjfkjngifkhiir
lilhffffffffffff		mnffhjilgtlnjrll
liliffffffffffff		mnjskhgflnmiklkp
liljffffffffffff		mnigfummitjlklfh
lilkffffffffffff		mnhjfoifjqiqhkfs
lillffffffffffff		mnlmgmkfmumtimit
lilmffffffffffff		mnhkkhfjkklghrff
lilnffffffffffff		mnhfmjljfpmmjqkf
liloffffffffffff		mniiiuiqhtljkghq
lilpffffffffffff		mnmsgrgmhtfujqkh
lilqffffffffffff		mnipihgfljksjnku
lilrffffffffffff		mnfnfhmflolqghhf
lilsffffffffffff		mnfliqinhiilitir
liltffffffffffff		mnltiogoiifggjgt
liluffffffffffff		mnmrgugimqiqinig
limfffffffffffff		mnkrihifkngrmpgg
limgffffffffffff		mnhslliifnknfsjg
limhffffffffffff		mnfsjtjmmtflkrgi
limiffffffffffff		mnhoiojsisfnklih
limjffffffffffff		mngpgghkkqirhrgj
limkffffffffffff		mnmkitltithilhit
limlffffffffffff		mnfhisfmmrjgfsgn
limmffffffffffff		mnmfhpjrhfjpkqin
limnffffffffffff		mnikmpkrksklmnio
limoffffffffffff		mnisiumfikmokpfm
limpffffffffffff		mnmqfijlgkjmmjmg
limqffffffffffff		mngsfrmpiukigfmq
limrffffffffffff		mnhllfftgpllgnir
limsffffffffffff		mnljjhkijiigfmmi
limtffffffffffff		mngkmngkmilhjolq
limuffffffffffff		mnjgfugpiugphiho
