lilnifififififff		mnhfjomsjsgfimlo
lilnifififififfg		mnhfjomsjsgfimmu
lilnifififififfh		mnhfjomsjsgfimfi
lilnifififififfi		mnhfjomsjsgfimij
lilnifififififfj		mnhfjomsjsgfimkl
lilnifififififfk		mnhfjomsjsgfimjk
lilnifififififfl		mnhfjomsjsgfimlu
lilnifififififfm		mnhfjomsjsgfimgu
lilnifififififfn		mnhfjomsjsgfimir
lilnifififififfo		mnhfjomsjsgfimfj
lilnifififififfp		mnhfjomsjsgfimmq
lilnifififififfq		mnhfjomsjsgfimiu
lilnifififififfr		mnhfjomsjsgfimls
lilnifififififfs		mnhfjomsjsgfimhn
lilnifififififft		mnhfjomsjsgfimjr
lilnifififififfu		mnhfjomsjsgfimjh
lilnifififififgf		mnhfjomsjsgfimht
lilnifififififgg		mnhfjomsjsgfimjg
lilnifififififgh		mnhfjomsjsgfimms
lilnifififififgi		mnhfjomsjsgfimgm
lilnifififififgj		mnhfjomsjsgfimkm
lilnifififififgk		mnhfjomsjsgfimfr
lilnifififififgl		mnhfjomsjsgfimlm
lilnifififififgm		mnhfjomsjsgfimfk
lilnifififififgn		mnhfjomsjsgfimhr
lilnifififififgo		mnhfjomsjsgfimgj
lilnifififififgp		mnhfjomsjsgfimgf
lilnifififififgq		mnhfjomsjsgfimgo
lilnifififififgr		mnhfjomsjsgfimio
lilnifififififgs		mnhfjomsjsgfimfs
lilnifififififgt		mnhfjomsjsgfimml
lilnifififififgu		mnhfjomsjsgfimku
lilnifififififhf		mnhfjomsjsgfimff
lilnifififififhg		mnhfjomsjsgfimhq
lilnifififififhh		mnhfjomsjsgfimlt
lilnifififififhi		mnhfjomsjsgfimgl
lilnifififififhj		mnhfjomsjsgfimim
lilnifififififhk		mnhfjomsjsgfimho
lilnifififififhl		mnhfjomsjsgfimfn
lilnifififififhm		mnhfjomsjsgfimkh
lilnifififififhn		mnhfjomsjsgfimmp
lilnifififififho		mnhfjomsjsgfimmi
lilnifififififhp		mnhfjomsjsgfimlq
lilnifififififhq		mnhfjomsjsgfimgs
lilnifififififhr		mnhfjomsjsgfimkk
lilnifififififhs		mnhfjomsjsgfimfm
lilnifififififht		mnhfjomsjsgfimmj
lilnifififififhu		mnhfjomsjsgfimmh
lilnifififififif		mnhfjomsjsgfimgg
lilnifififififig		mnhfjomsjsgfimfh
lilnifififififih		mnhfjomsjsgfimhp
lilnifififififii		mnhfjomsjsgfimkq
lilnifififififij		mnhfjomsjsgfimlk
lilnifififififik		mnhfjomsjsgfimjl
lilnifififififil		mnhfjomsjsgfimgh
lilnifififififim		mnhfjomsjsgfimjs
lilnifififififin		mnhfjomsjsgfimli
lilnifififififio		mnhfjomsjsgfimfg
lilnifififififip		mnhfjomsjsgfimjm
lilnifififififiq		mnhfjomsjsgfimhf
lilnifififififir		mnhfjomsjsgfimhh
lilnifififififis		mnhfjomsjsgfimjo
lilnifififififit		mnhfjomsjsgfimgp
lilnifififififiu		mnhfjomsjsgfimii
lilnifififififjf		mnhfjomsjsgfimip
lilnifififififjg		mnhfjomsjsgfimhg
lilnifififififjh		mnhfjomsjsgfimkg
lilnifififififji		mnhfjomsjsgfimgk
lilnifififififjj		mnhfjomsjsgfimll
lilnifififififjk		mnhfjomsjsgfimmt
lilnifififififjl		mnhfjomsjsgfimgn
lilnifififififjm		mnhfjomsjsgfimgt
lilnifififififjn		mnhfjomsjsgfimis
lilnifififififjo		mnhfjomsjsgfimki
lilnifififififjp		mnhfjomsjsgfimlj
lilnifififififjq		mnhfjomsjsgfimlf
lilnifififififjr		mnhfjomsjsgfimfp
lilnifififififjs		mnhfjomsjsgfimmk
lilnifififififjt		mnhfjomsjsgfimkr
lilnifififififju		mnhfjomsjsgfimgq
lilnifififififkf		mnhfjomsjsgfimmm
lilnifififififkg		mnhfjomsjsgfimmf
lilnifififififkh		mnhfjomsjsgfimks
lilnifififififki		mnhfjomsjsgfimkt
lilnifififififkj		mnhfjomsjsgfimfu
lilnifififififkk		mnhfjomsjsgfimit
lilnifififififkl		mnhfjomsjsgfimko
lilnifififififkm		mnhfjomsjsgfimgr
lilnifififififkn		mnhfjomsjsgfimju
lilnifififififko		mnhfjomsjsgfimhl
lilnifififififkp		mnhfjomsjsgfimih
lilnifififififkq		mnhfjomsjsgfimkf
lilnifififififkr		mnhfjomsjsgfimjt
lilnifififififks		mnhfjomsjsgfimmo
lilnifififififkt		mnhfjomsjsgfimkn
lilnifififififku		mnhfjomsjsgfimlh
lilnifififififlf		mnhfjomsjsgfimhk
lilnifififififlg		mnhfjomsjsgfimlr
lilnifififififlh		mnhfjomsjsgfimji
lilnifififififli		mnhfjomsjsgfimgi
lilnifififififlj		mnhfjomsjsgfimlp
lilnifififififlk		mnhfjomsjsgfimln
lilnifififififll		mnhfjomsjsgfimfq
lilnifififififlm		mnhfjomsjsgfimjp
lilnifififififln		mnhfjomsjsgfimjf
lilnifififififlo		mnhfjomsjsgfimhi
lilnifififififlp		mnhfjomsjsgfimhm
lilnifififififlq		mnhfjomsjsgfimfl
lilnifififififlr		mnhfjomsjsgfimhs
lilnifififififls		mnhfjomsjsgfimin
lilnifififififlt		mnhfjomsjsgfimil
lilnifififififlu		mnhfjomsjsgfimlg
lilnifififififmf		mnhfjomsjsgfimig
lilnifififififmg		mnhfjomsjsgfimft
lilnifififififmh		mnhfjomsjsgfimik
lilnifififififmi		mnhfjomsjsgfimkp
lilnifififififmj		mnhfjomsjsgfimhu
lilnifififififmk		mnhfjomsjsgfimkj
lilnifififififml		mnhfjomsjsgfimjq
lilnifififififmm		mnhfjomsjsgfimmr
lilnifififififmn		mnhfjomsjsgfimjn
lilnifififififmo		mnhfjomsjsgfimhj
lilnifififififmp		mnhfjomsjsgfimiq
lilnifififififmq		mnhfjomsjsgfimjj
lilnifififififmr		mnhfjomsjsgfimfo
lilnifififififms		mnhfjomsjsgfimmg
lilnifififififmt		mnhfjomsjsgfimmn
lilnifififififmu		mnhfjomsjsgfimif
