lilnffffffffffff		mnhfmjljfpmmjqkf
lilnfgffffffffff		mnhflgiplnhpifil
lilnfhffffffffff		mnhfklipgphiiumk
lilnfiffffffffff		mnhflilmjjlfhmlh
lilnfjffffffffff		mnhflpiumujmmqmt
lilnfkffffffffff		mnhfiniuitmnhuik
lilnflffffffffff		mnhfmthtgqjulhgg
lilnfmffffffffff		mnhflfkfjmiughim
lilnfnffffffffff		mnhfmpmgljikklju
lilnfoffffffffff		mnhfkmlkgihtmpmp
lilnfpffffffffff		mnhfftmlmuiqklfm
lilnfqffffffffff		mnhffjltmuftjfmt
lilnfrffffffffff		mnhfhqifhgjrlqlj
lilnfsffffffffff		mnhffhikhjkthhln
lilnftffffffffff		mnhfiofmkujnjoln
lilnfuffffffffff		mnhfkghmfmkkhslq
lilngfffffffffff		mnhfimgkhtktgmiu
lilnggffffffffff		mnhfjkmumthmlmlg
lilnghffffffffff		mnhfglmuhijjkjfo
lilngiffffffffff		mnhfgihgghlllqgi
lilngjffffffffff		mnhflmgghpkoiqin
lilngkffffffffff		mnhfgfimihloltll
lilnglffffffffff		mnhfhfklmgkijijo
lilngmffffffffff		mnhfgkljgqlhhliu
lilngnffffffffff		mnhfhpjohuitkmfs
lilngoffffffffff		mnhfhuhrklltlijj
lilngpffffffffff		mnhfismpfiggmslg
lilngqffffffffff		mnhffujkfjkhhokq
lilngrffffffffff		mnhfhihjlumuisjj
lilngsffffffffff		mnhfmrghjtirhrhp
lilngtffffffffff		mnhfhohnhljkinil
lilnguffffffffff		mnhfgpklholljojj
lilnhfffffffffff		mnhfhklohugmgqjk
lilnhgffffffffff		mnhffpkpmummkilu
lilnhhffffffffff		mnhfmqjljggukjmr
lilnhiffffffffff		mnhfgofufmjflsjs
lilnhjffffffffff		mnhfllijkhfjhnjt
lilnhkffffffffff		mnhffmmffnfihlhn
lilnhlffffffffff		mnhfgrhugrfkmtln
lilnhmffffffffff		mnhffrfhmmihfhmj
lilnhnffffffffff		mnhfipfkhliokniq
lilnhoffffffffff		mnhffgfjkuhfiqlf
lilnhpffffffffff		mnhfjsmskhgmlfik
lilnhqffffffffff		mnhfjuihgngiklfh
lilnhrffffffffff		mnhfjqhihtjhkflk
lilnhsffffffffff		mnhfhrklhglnimfu
lilnhtffffffffff		mnhflsfskjjpmjhk
lilnhuffffffffff		mnhflqmomjhumpjk
lilnifffffffffff		mnhfjofqhhfphjjr
lilnigffffffffff		mnhfjljgghmjjqkj
lilnihffffffffff		mnhfltmpinfjgtms
lilniiffffffffff		mnhfijkhlhgnmrjr
lilnijffffffffff		mnhffoiqifmhhilm
lilnikffffffffff		mnhffqmrfpfpknhq
lilnilffffffffff		mnhfihlgfkjplmik
lilnimffffffffff		mnhfmuiujnmofrhg
lilninffffffffff		mnhfkjhkkhlpghkp
lilnioffffffffff		mnhfgghjhgimgkjt
lilnipffffffffff		mnhfhgfofsgqflgh
lilniqffffffffff		mnhfjjgskffmighq
lilnirffffffffff		mnhfhnkgktjhfifj
lilnisffffffffff		mnhfkffiihimgogj
lilnitffffffffff		mnhfmflfjhkilrhp
lilniuffffffffff		mnhfmgmtljlgfsmh
lilnjfffffffffff		mnhfmimhlmgommlr
lilnjgffffffffff		mnhflnjllggpgrhh
lilnjhffffffffff		mnhfjplujsmfgtmi
lilnjiffffffffff		mnhfikhofnknjrlk
lilnjjffffffffff		mnhfiqkrijlrfhih
lilnjkffffffffff		mnhfkpflishoilms
lilnjlffffffffff		mnhfluknjijtgpiq
lilnjmffffffffff		mnhfhjmpkjhkmllt
lilnjnffffffffff		mnhfiugqktghiokr
lilnjoffffffffff		mnhfmlffimgrmofn
lilnjpffffffffff		mnhfkoljmmhhgtji
lilnjqffffffffff		mnhffliuksmilplu
lilnjrffffffffff		mnhfgsmrloirlkih
lilnjsffffffffff		mnhffkfkhthhhkff
lilnjtffffffffff		mnhfiljomgmogsio
lilnjuffffffffff		mnhfhhkjfqimmhkl
lilnkfffffffffff		mnhfjfirlugshjmt
lilnkgffffffffff		mnhfmnmhikfimrgf
lilnkhffffffffff		mnhfjmkkfflhloip
lilnkiffffffffff		mnhfjrggkoiffjjk
lilnkjffffffffff		mnhfjiirkpgqjngu
lilnkkffffffffff		mnhfirhogrlpigkg
lilnklffffffffff		mnhflhkmgfgqfsgm
lilnkmffffffffff		mnhfkqhillhugqhu
lilnknffffffffff		mnhfljffijmthqil
lilnkoffffffffff		mnhfffiijqkjfqkn
lilnkpffffffffff		mnhfiiithmjlmqms
lilnkqffffffffff		mnhfkkktgslpgigi
lilnkrffffffffff		mnhfknknmikpgqgr
lilnksffffffffff		mnhfksgjmlluipjp
lilnktffffffffff		mnhfjtgpfojumjfo
lilnkuffffffffff		mnhffiimlgkkkhjl
lilnlfffffffffff		mnhfhmhtjtltgshi
lilnlgffffffffff		mnhfmmjmiihojhfq
lilnlhffffffffff		mnhfgtkjkgljkohs
lilnliffffffffff		mnhflogriifilmii
lilnljffffffffff		mnhfghmmklhkfsjh
lilnlkffffffffff		mnhfkuhskmmsmmml
lilnllffffffffff		mnhfgqmqkpitjjll
lilnlmffffffffff		mnhfhtlthlilmglk
lilnlnffffffffff		mnhfguhrhfigisim
lilnloffffffffff		mnhffngoimhrfhlk
lilnlpffffffffff		mnhfgmhqmkiifijs
lilnlqffffffffff		mnhflrisjpjgfmku
lilnlrffffffffff		mnhflkjgjtiuflfg
lilnlsffffffffff		mnhffsitmfilllku
lilnltffffffffff		mnhfmhfrkjgkhijh
lilnluffffffffff		mnhfigklllhugpmo
lilnmfffffffffff		mnhfjnkrfqkumrjq
lilnmgffffffffff		mnhfifkihkjuhrmt
lilnmhffffffffff		mnhfgnkjgfkqlgkf
lilnmiffffffffff		mnhfkrjnlijfmfmi
lilnmjffffffffff		mnhfktmfffhhlfjk
lilnmkffffffffff		mnhfitfqftkihflr
lilnmlffffffffff		mnhfmsjmipgtgpgg
lilnmmffffffffff		mnhfmkknhkhoksfp
lilnmnffffffffff		mnhfkihlljhifmjl
lilnmoffffffffff		mnhfmogpmghmfglr
lilnmpffffffffff		mnhfkhhsfokmhplo
lilnmqffffffffff		mnhfhsigifkhjhgk
lilnmrffffffffff		mnhfgjhugtlhgomg
lilnmsffffffffff		mnhfhlfnioghhqfs
lilnmtffffffffff		mnhfjgjtkqkgjnhh
lilnmuffffffffff		mnhfjhiohumthpkt
